wwwwwwwwwwwwwwwwwww
w P               w 
w            wwwwww
w       E         w
w                 w
w                 w
w        wwwwwwwwww
w                 w
w                 w
wwwwwwwwww        w
w            wwwwww
w                 w
w            wwwwww
w            E   Tw
wwwwwwwwwwwwwwwwwww